{"level": 1,
    "size": 10,
    "start": [4,2],"end": [4,8],
  "map":
  [
    [0,0,0,0,0,0,0,0,0,0],
    [0,0,0,0,0,0,0,0,0,0],
    [1,1,1,1,1,1,1,1,1,1],
    [1,1,1,1,1,1,1,1,1,1],
    [1,1,1,1,1,1,1,1,1,1],
    [1,1,1,1,1,1,1,1,1,1],
    [1,1,1,1,1,1,1,1,1,1],
    [0,0,0,0,0,0,0,0,0,0],
    [0,0,0,0,0,0,0,0,0,0],
    [0,0,0,0,0,0,0,0,0,0]
  ]
}
