{"level": 1,
    "size": 10,
    "start": [0,0],"end": [7,9],
  "map":
  [
    [1,1,1,1,1,1,1,1,1,0],
    [1,1,1,1,0,0,0,1,1,1],
    [1,0,1,1,1,0,0,0,0,1],
    [1,0,1,1,1,1,0,0,0,1],
    [1,0,0,1,1,1,0,0,0,1],
    [1,0,0,0,1,1,1,1,0,1],
    [1,0,0,1,1,0,1,1,0,1],
    [1,0,1,1,1,1,1,1,1,1],
    [1,0,1,1,0,0,0,1,1,0],
    [1,1,1,1,1,1,1,1,1,1]
  ]
}
