{"level": 1,
    "size": 12,
    "start": [4,5],"end": [10,1],
  "map":
  [
    [1,1,1,1,1,0,0,0,0,0,0,0],
    [1,0,1,1,1,1,1,1,1,1,1,1],
    [1,0,1,1,0,1,1,0,1,0,1,1],
    [1,0,1,1,0,1,1,0,1,0,1,1],
    [1,0,1,1,1,1,0,1,1,1,1,1],
    [1,1,0,0,0,0,0,1,1,0,0,0],
    [1,1,1,0,0,0,0,1,1,1,0,0],
    [0,1,1,1,1,1,1,0,1,1,1,0],
    [0,1,1,1,0,0,1,0,0,1,1,0],
    [0,0,0,0,1,1,1,1,1,1,1,0],
    [0,1,1,1,1,1,1,0,0,0,0,0],
    [0,0,0,0,0,0,0,0,0,0,0,0]
  ]
}
