{"level": 11,
    "size": 10,
    "start": [5,7],"end": [7,4],
  "map":
  [
    [0,0,0,0,0,0,0,0,0,0],
    [0,0,0,0,0,0,0,0,0,0],
    [0,0,1,1,1,1,1,0,0,0],
    [1,1,1,1,0,1,1,1,1,1],
    [1,1,1,1,0,1,1,1,0,0],
    [1,1,0,0,0,1,1,1,0,0],
    [1,1,1,1,0,0,0,0,0,0],
    [1,1,1,1,1,0,0,0,0,0],
    [0,0,0,0,0,0,0,0,0,0],
    [0,0,0,0,0,0,0,0,0,0]
  ]
}