{"level": 12,
    "size": 9,
    "start": [4,3],"end": [3,4],
  "map":
  [
    [0,0,0,0,0,0,0,0,0],
    [1,1,1,1,1,1,1,1,0],
    [1,0,1,0,1,0,1,1,0],
    [1,1,1,1,1,1,1,1,1],
    [1,1,0,1,1,0,1,1,1],
    [1,1,0,1,1,0,0,1,0],
    [0,1,1,1,1,1,1,1,0],
    [0,0,0,0,0,0,0,0,0],
    [0,0,0,0,0,0,0,0,0]
  ]
}