{"level": 15,
    "size": 11,
    "start": [6,10],"end": [2,0],
  "map":
  [
    [0,0,0,0,0,0,0,0,0,0,0],
    [0,0,0,0,0,0,0,0,0,0,0],
    [1,1,1,1,1,1,1,1,0,0,0],
    [1,1,0,0,0,1,1,1,1,1,0],
    [1,1,1,0,1,1,1,0,0,1,0],
    [0,0,1,1,1,0,0,1,1,1,1],
    [0,0,1,1,1,0,1,1,1,1,1],
    [1,1,1,1,0,1,1,1,1,1,0],
    [1,1,1,1,1,1,1,1,0,0,0],
    [0,0,0,0,0,0,0,0,0,0,0],
    [0,0,0,0,0,0,0,0,0,0,0]
  ]
}