{"level": 16,
    "size": 11,
    "start": [2,3],"end": [2,10],
  "map":
  [
    [0,0,0,0,0,0,0,0,0,0,0],
    [0,0,0,0,0,0,0,0,0,0,0],
    [1,1,1,1,0,1,1,1,1,1,1],
    [1,1,1,1,0,1,1,1,0,1,1],
    [1,1,1,1,1,1,0,0,0,0,1],
    [0,1,1,0,0,0,0,1,1,1,1],
    [0,0,1,1,1,0,0,1,1,1,0],
    [0,0,0,1,1,1,1,1,1,0,0],
    [0,0,0,0,1,1,1,1,0,0,0],
    [0,0,0,0,0,0,0,0,0,0,0],
    [0,0,0,0,0,0,0,0,0,0,0]
  ]
}