{"level": 18,
    "size": 10,
    "start": [6,1],"end": [2,9],
  "map":
  [
    [0,0,0,0,0,0,0,0,0,0],
    [0,0,0,0,0,0,0,1,1,1],
    [0,0,0,0,0,0,0,1,1,1],
    [0,0,0,0,0,0,0,1,1,1],
    [0,0,0,1,1,1,1,1,0,0],
    [1,1,0,1,1,1,1,1,0,0],
    [1,1,1,1,0,0,0,0,0,0],
    [1,1,1,1,0,0,0,0,0,0],
    [0,0,0,0,0,0,0,0,0,0],
    [0,0,0,0,0,0,0,0,0,0]
  ]
}