{"level": 19,
    "size": 10,
    "start": [8,4],"end": [3,7],
  "map":
  [
    [0,0,0,0,0,0,0,0,0,0],
    [0,1,1,1,1,1,1,1,0,0],
    [0,1,0,1,0,0,0,1,1,0],
    [0,1,1,1,1,1,1,1,1,0],
    [0,1,0,1,0,0,0,1,0,0],
    [0,1,0,1,0,1,1,1,1,0],
    [0,1,0,1,0,1,1,1,1,0],
    [0,1,1,1,1,1,0,0,0,0],
    [0,1,1,1,1,1,0,0,0,0],
    [0,0,0,0,0,0,0,0,0,0]
  ]
}