{"level": 20,
    "size": 12,
    "start": [5,0],"end": [9,5],
  "map":
  [
    [0,0,0,0,0,0,0,0,0,0,0,0],
    [0,0,0,0,0,0,0,0,0,0,0,0],
    [0,0,1,1,1,1,1,1,1,1,1,1],
    [0,1,1,1,0,1,1,1,0,0,0,1],
    [0,1,0,1,1,1,1,1,0,1,1,1],
    [1,1,1,1,0,0,0,0,1,1,1,1],
    [0,0,1,1,1,1,1,1,1,0,1,1],
    [0,0,1,0,1,1,1,1,0,1,1,1],
    [0,0,1,0,1,0,1,1,1,1,1,0],
    [0,0,1,1,1,1,1,0,0,0,0,0],
    [0,0,0,0,0,0,0,0,0,0,0,0],
    [0,0,0,0,0,0,0,0,0,0,0,0]
  ]
}