{"level": 7,
    "size": 9,
    "start": [1,1],"end": [7,7],
  "map":
  [
    [0,0,0,0,0,0,0,0,0],
    [0,1,1,1,1,0,0,0,0],
    [0,1,1,0,1,0,0,0,0],
    [0,1,0,1,1,0,0,0,0],
    [0,1,1,1,1,1,1,1,0],
    [0,0,0,0,1,1,0,1,0],
    [0,0,0,0,1,0,1,1,0],
    [0,0,0,0,1,1,1,1,0],
    [0,0,0,0,0,0,0,0,0]
  ]
}